1111111111111111111111111111111111111111111111
1E0000000000000C00000C0C00000C0000000000000001
1111111111111111111111111111111111111111111101
1000000000000000000000000000000000000000000001
1011111111111111111111111111111111111111111111
10000000000000000000000000000000000000000000P1
1111111111111111111111111111111111111111111111
