11111111111111111111111111111111111111
1E000000000000000000000000000000000001
10111111111111111111111111111111111101
10100000000000000000000000000000000101
10100000000000000000000000000000000101
10100000000000000000000000000000000101
10100000000000000000000000000000000101
10100000000000000000000000000000000101
10100000000000000000000000000000000101
10100000000000000000000000000000000101
10100000000000000000000000000000000101
10100000000000000000000000000000000101
10100000000000000000000000000000000101
10100000000000000000000000000000000101
10100000000000000000000000000000000101
10111111111111111111111111111111111101
1C0000000000000000000000000000000000P1
11111111111111111111111111111111111111
