111111111111111111111111111111111111111111111111111111111
1E0000000000000000000000000C00000000000000000000000000001
101111111111111111111111111111111111111111111111111110101
101010101010101000000000000000000000000000101010101010101
101010101010101000000000000000000000000000101010101010101
101000100010001000000000000000000000000000101000100010101
101010101010101000000000000000000000000000101010101010101
101010101010101000000000000000000000000000001010101010101
101010101010101000000000000000000000000000101010101010101
101010101010101000000000000000000000000000101010101010101
101010101010100000000000000000000000000000101010101010101
101010101010101000000000000000000000000000101010101010101
101010001000101000000000000000000000000000100010001000101
101010101010101000000000000000000000000000101010101010101
101010101010101000000000000000000000000000101010101010101
101011111111111111111111111111111111111111111111111111101
1000000000000000000000000000000000000000000000000000000P1
111111111111111111111111111111111111111111111111111111111
