11111111111111111111111111111111111111
10000000000100000000000000000000000001
10C11000000100100001111111111110010C01
10001000100000100000000000000000010001
10001000100000100000110000000000010001
10011000100C11100000011100111000000001
10000000100010000000000100100011100001
10000000111110111111110111100010000001
10011000000000000P0000000000001C000001
100C1000000000111111100000000011111111
10011000000000000000000000000000000001
10000000000000000001111111100111111001
10000000000000000001000000100100000001
10111111110000100001000000100100000C01
100000C0000000100000000C00000100000001
10011111111000100000111111000111110001
10000000000000100E00100001000000000001
11111111111111111111111111111111111111
